25 
25 
1000000000000090000900001
1000000000000090000900001
1000000000000090110900001
1000000000000111111110001
1000000000005000000000001

1000000000005000000000001
1000008000005000000000001
1000111111000001111110001
1000000000000000000000001
1000000000000000000000001
1000000000000000000000001
1000200020001000200010001
1000000000000000000000001
1000000000000000000000001
1000000000000000000000001

1000000011100011100010001
1000020000100010000000001
1000000000100010000000001
1000000000100000000000001
1000300000000000000000001
1000000000000000090000901
1000000000011110090000901
1000200000000000090110901
1000000000000000111111111
1444444444444444444444441